300:300
///X//////=X=X=/////=X///
///====///=====///===////
//////=///=====///=//////
//////=///=====///=//////
////===///=====///=//////
////=/////=====///=====//
////==////=====///////=//
/////=////=====///////=//
/////==///=============//
//////=///=====//////////
/////==///=====//////////
/////=////========///////
/////=////=====//=///////
/////======PPP====///////