300:300
//////////=X=X=//////////
//////////=====//////////
//////////=====//////////
//////////=====//////////
//////////=====//////////
//////////=====//////////
//////////=====//////////
//////////=====//////////
//////////=====//////////
//////////=====//////////
//////////=====//////////
//////////=====//////////
//////////=====//////////
//////////=PPP=//////////